Id,name,GP,GW,GL,GP%,GW%
1,Incineroar,3801,1903,1898,73.40%,50.10%
2,Zacian Crowned Sword,2778,1438,1340,53.70%,51.80%
3,Kyogre,1909,1022,887,36.90%,53.50%
4,Grimmsnarl,1574,792,782,30.40%,50.30%
5,Rillaboom,1424,709,715,27.50%,49.80%
6,Thundurus Incarnate ,1421,719,702,27.40%,50.60%
7,Groudon,1381,683,698,26.70%,49.50%
8,Regieleki,1359,642,717,26.20%,47.20%
9,Charizard,1063,549,514,20.50%,51.60%
10,Amoonguss,1043,557,486,20.10%,53.40%
11,Venusaur,1016,505,511,19.60%,49.70%
12,Calyrex Shadow Rider,854,396,458,16.50%,46.40%
13,Whimsicott,823,416,407,15.90%,50.50%
14,Landorus Therian ,780,420,360,15.10%,53.80%
15,Calyrex Ice Rider,751,365,386,14.50%,48.60%
16,Porygon2,684,334,350,13.20%,48.80%
17,Yveltal,673,333,340,13.00%,49.50%
18,Gastrodon,583,294,289,11.30%,50.40%
19,Tornadus Incarnate ,570,314,256,11.00%,55.10%
20,Palkia,527,247,280,10.20%,46.90%
21,Kartana,479,264,215,9.30%,55.10%
22,Lunala,436,215,221,8.40%,49.30%
23,Indeedee Female,378,171,207,7.30%,45.20%
24,Tapu Fini,369,178,191,7.10%,48.20%
26,Blastoise,258,127,131,5.00%,49.20%
27,Zapdos,244,116,128,4.70%,47.50%
28,Solgaleo,226,103,123,4.40%,45.60%
29,Reshiram,183,91,92,3.50%,49.70%
30,Urshifu Single Strike,170,94,76,3.30%,55.30%
31,Shedinja,160,88,72,3.10%,55.00%
32,Dialga,154,72,82,3.00%,46.80%
33,Mimikyu,140,65,75,2.70%,46.40%
34,Umbreon,136,61,75,2.60%,44.90%
35,Slowbro,132,84,48,2.50%,63.60%
36,Torkoal,109,50,59,2.10%,45.90%
37,Eternatus,103,48,55,2.00%,46.60%
38,White Kyurem,93,42,51,1.80%,45.20%
39,Ditto,83,36,47,1.60%,43.40%
40,Ferrothorn,76,34,42,1.50%,44.70%
41,Gothitelle,72,31,41,1.40%,43.10%
42,Bronzong,69,33,36,1.30%,47.80%
43,Clefairy,66,37,29,1.30%,56.10%
44,Xerneas,63,25,38,1.20%,39.70%
45,Sableye,61,28,33,1.20%,45.90%
46,Heat Rotom,52,19,33,1.00%,36.50%
47,Weezing,50,18,32,1.00%,36.00%
48,Coalossal,49,29,20,0.90%,59.20%
49,Rayquaza,46,20,26,0.90%,43.50%
50,Raichu,45,21,24,0.90%,46.70%
51,Regigigas,43,13,30,0.80%,30.20%
52,Galarian Moltres,39,20,19,0.80%,51.30%
53,Talonflame,37,16,21,0.70%,43.20%
54,Snorlax,35,20,15,0.70%,57.10%
55,Celesteela,35,19,16,0.70%,54.30%
56,Dragapult,30,17,13,0.60%,56.70%
57,Entei,30,13,17,0.60%,43.30%
58,Seismitoad,27,14,13,0.50%,51.90%
59,Suicune,24,8,16,0.50%,33.30%
60,Ho-oh,22,10,12,0.40%,45.50%
61,Lugia,22,7,15,0.40%,31.80%
62,Volcarona,21,10,11,0.40%,47.60%
63,Araquanid,19,8,11,0.40%,42.10%
64,Dusclops,18,13,5,0.30%,72.20%
65,Tapu Koko,18,9,9,0.30%,50.00%
66,Hydreigon,16,7,9,0.30%,43.80%
67,Comfey,16,6,10,0.30%,37.50%
68,Thundurus Therian ,15,10,5,0.30%,66.70%
69,Spectrier,15,7,8,0.30%,46.70%
70,Lapras,15,5,10,0.30%,33.30%
71,Landorus Incarnate ,14,7,7,0.30%,50.00%
72,Barraskewda,14,6,8,0.30%,42.90%
73,Alolan Exeggutor,13,8,5,0.30%,61.50%
74,Alcremie,13,6,7,0.30%,46.20%
75,Kingdra,12,8,4,0.20%,66.70%
76,Alolan Persian,12,5,7,0.20%,41.70%
77,Gyarados,12,4,8,0.20%,33.30%
78,Tyranitar,12,2,10,0.20%,16.70%
79,Terrakion,11,4,7,0.20%,36.40%
80,Weavile,10,5,5,0.20%,50.00%
81,Zamazenta Crowned Shield,10,3,7,0.20%,30.00%
82,Nihilego,10,3,7,0.20%,30.00%
83,Hatterene,10,3,7,0.20%,30.00%
84,Raikou,10,2,8,0.20%,20.00%
85,Liepard,10,0,10,0.20%,0.00%
86,Eldegoss,9,3,6,0.20%,33.30%
87,Metagross,9,3,6,0.20%,33.30%
88,Trevenant,7,6,1,0.10%,85.70%
89,Hitmontop,7,6,1,0.10%,85.70%
90,Sneasel,7,5,2,0.10%,71.40%
91,Salamence,7,3,4,0.10%,42.90%
93,Dusk Mane Necrozma,7,2,5,0.10%,28.60%
94,Milotic,7,2,5,0.10%,28.60%
95,Cinderace,7,2,5,0.10%,28.60%
96,Garchomp,7,1,6,0.10%,14.30%
97,Krookodile,7,1,6,0.10%,14.30%
98,Chandelure,6,6,0,0.10%,100.00%
100,Zekrom,6,2,4,0.10%,33.30%
101,Golisopod,6,2,4,0.10%,33.30%
102,Pikachu,5,4,1,0.10%,80.00%
103,Tsareena,5,4,1,0.10%,80.00%
105,Trapinch,5,2,3,0.10%,40.00%
106,Aerodactyl,5,2,3,0.10%,40.00%
107,Hitmonlee,5,1,4,0.10%,20.00%
108,Rhyperior,5,1,4,0.10%,20.00%
109,Dracozolt,5,1,4,0.10%,20.00%
110,Mr. Rime,4,4,0,0.10%,100.00%
111,Dugtrio,4,2,2,0.10%,50.00%
112,Indeedee Male,4,2,2,0.10%,50.00%
113,Zygarde 50% ,4,2,2,0.10%,50.00%
114,Magikarp,4,2,2,0.10%,50.00%
115,Registeel,4,2,2,0.10%,50.00%
116,Copperajah,4,0,4,0.10%,0.00%
117,Toxapex,4,0,4,0.10%,0.00%
118,Aggron,4,0,4,0.10%,0.00%
119,Stakataka,4,0,4,0.10%,0.00%
120,Meowstic Male,3,2,1,0.10%,66.70%
122,Mienshao,3,2,1,0.10%,66.70%
123,Mr. Mime,3,2,1,0.10%,66.70%
124,Heliolisk,3,2,1,0.10%,66.70%
125,Pyukumuku,3,1,2,0.10%,33.30%
126,Alolan Ninetales,3,1,2,0.10%,33.30%
127,Beartic,3,1,2,0.10%,33.30%
128,Tyrantrum,3,1,2,0.10%,33.30%
129,Glastrier,3,1,2,0.10%,33.30%
130,Mewtwo,3,1,2,0.10%,33.30%
131,Arcanine,3,1,2,0.10%,33.30%
132,Seaking,3,1,2,0.10%,33.30%
133,Azelf,3,1,2,0.10%,33.30%
134,Turtonator,3,1,2,0.10%,33.30%
135,Torracat,3,1,2,0.10%,33.30%
136,Emolga,3,1,2,0.10%,33.30%
137,Azumarill,3,1,2,0.10%,33.30%
138,Mamoswine,3,1,2,0.10%,33.30%
139,Drampa,3,1,2,0.10%,33.30%
140,Greedent,2,2,0,0.00%,100.00%
141,Dracovish,2,2,0,0.00%,100.00%
143,Giratina Origin ,2,2,0,0.00%,100.00%
144,Centiskorch,2,2,0,0.00%,100.00%
145,Kangaskhan,2,2,0,0.00%,100.00%
146,Cradily,2,2,0,0.00%,100.00%
147,Zacian Hero of Many Battles,2,0,2,0.00%,0.00%
148,Giratina Altered ,2,0,2,0.00%,0.00%
149,Riolu,2,0,2,0.00%,0.00%
150,Electivire,2,0,2,0.00%,0.00%
151,Chansey,2,0,2,0.00%,0.00%
152,Shuckle,2,0,2,0.00%,0.00%
153,Regidrago,2,0,2,0.00%,0.00%
155,Galarian Weezing,2,0,2,0.00%,0.00%
156,Blacephalon,2,0,2,0.00%,0.00%
157,Mudkip,2,0,2,0.00%,0.00%
158,Jellicent,2,0,2,0.00%,0.00%
159,Dubwool,2,0,2,0.00%,0.00%
160,Butterfree,2,0,2,0.00%,0.00%
161,Morpeko Hangry Mode,2,0,2,0.00%,0.00%
162,Jynx,2,0,2,0.00%,0.00%
163,Maractus,2,0,2,0.00%,0.00%
164,Tapu Lele,2,0,2,0.00%,0.00%
165,Alolan Marowak,2,0,2,0.00%,0.00%
166,Tangrowth,2,0,2,0.00%,0.00%
167,Mantine,2,0,2,0.00%,0.00%
